You've needed extra cash and this science lab was willing to pay good money for you to be a "test bunny". You took this chemical mixture but it did nothing at first so the scientists left you alone in the test room until later on. After and hour you end up being shrunk to three inches tall. You now realize how serious these scientists are and you must figure out how to get yourself back to normal proportions and escape the lab
Tonic
An Interactive Fiction by Brianna Hartner
Release 1 / Serial number 130316 / Inform 7 build 6G60 (I6/v6.32 lib 6/12N) SD

Test Room
Pitch white walls surround you. There is a tinted window on the north side of the room. There is a table on the south side of the room and a chair on the east side. On the west side of the room, there is a door.

You can see a Big Metal Door here.

>talk
Why are you talking to yourself?

>help
That's not a verb I recognise.

* * *

>take thingy
Taken.

>open big metal door with arm thingy
You unlock the Big Metal Door.

>open door
You open the Big Metal Door.

>w
You can't go that way.

>enter
You must supply a noun.

>enter the big metal door
You can't go that way.

>enter the hallway
You can't see any such thing.

>w
You can't go that way.

>open door
That's already open.

>go through door
You can't go that way.

>enter door
You can't go that way.

>w
You can't go that way.

>w
You can't go that way.

>e
Shady Glades
You're underneath the chair blocking out those harshly bright lights providing a cooling shade. The Open Test Room is to the west of you and the chair is directly above you.

>w
Test Room
Pitch white walls surround you. There is a tinted window on the north side of the room. There is a table on the south side of the room and a chair on the east side. There is a big metal door on the west side of the room.

>w
You can't go that way.

I beg your pardon?

I beg your pardon?

>w
You can't go that way.

>ww
That's not a verb I recognise.

>w
You can't go that way.

* * *

>ww
That's not a verb I recognise.

>ww
That's not a verb I recognise.

* * *

>i
You are carrying nothing.

>x myself
You're dressed casually. You've got a green t-shirt on and black shorts. Oh and you're also only 3 inches tall.

>everyday i'm shuffling
Hallway
It's not too different from the Test Room, just in hallway shape: There's those bright white walls and cold tile floor. The Test Room is to the East. There's a door to the west that says "Chemical Lab" on it and to the south a door that says "Exit". The Hallway continues to the north, past a trash can in the Northeast corner.

You can see an Exit Door, a Steel Door, a Big Metal Door and a Scientist here.

>talk to scientist
That's not a verb I recognise.

>talk
That's not a verb I recognise.

>speak
I didn't understand that sentence.

>speak to scientist
I didn't understand that sentence.

>xyzzy
Doritos could be made without the powder and taste exactly the same. It was left on because it was decided that the residue left on your fingers was part of the "Doritos experience".

>x scientist
He's just leaning against the wall, playing around with his phone. Hmm maybe he's on break. You look up at his face and realise he was the man that gave you the shrinking potion and told you to go into the Test Room. Dr Cooper, I think.

It's seems like he does not notice you.

>x scientist
He's just leaning against the wall, playing around with his phone. Hmm maybe he's on break. You look up at his face and realise he was the man that gave you the shrinking potion and told you to go into the Test Room. Dr Cooper, I think.

* * *

>take all
Hey maybe you should actually TRY and play the game, you little cheater. K, thanks.

* * *

>unlock big metal door with arm thingy
You can't see any such thing.

* * *

>s
Dust Bunny Hideout
You're underneath the table revealing a farm of dust bunnies. The Open Test room is north of you and the table is directly above you.

You can see a Spatula here.

>x bunnies
They are big and gray and scary.

>take bunnies
Those critters aren't going to fit in you back pocket while you're still three inches tall.

>x me
You're dressed casually. You've got a green t-shirt on and black shorts - not like it matters right now.

* * *

>s
Dust Bunny Hideout
You're underneath the table revealing a farm of dust bunnies. The Open Test room is north of you and the table is directly above you.

You can see a Spatula here.

>take spatula
Taken.

>u
Top of the World
Even though you're only four feet off the ground, it seems like you're on top of the world.

You can see a Pair of Tongs here.

>take tongs
Taken.

>d
Dust Bunny Hideout
You're underneath the table revealing a farm of dust bunnies. The Open Test room is north of you and the table is directly above you.

>n
Test Room
Pitch white walls surround you. There is a tinted window on the north side of the room. There is a table on the south side of the room and a chair on the east side. There is a big metal door on the west side of the room.

>e
Shady Glades
You're underneath the chair blocking out those harshly bright lights providing a cooling shade. The Open Test Room is to the west of you and the chair is directly above you.

>u
New Perspective
You're on the seat of the chair.

You can see a Clamp here.

>take clamp
Taken.

* * *

>combine clamp spatula thingy with tongs
I didn't understand that sentence.

>undo
New Perspective
[Previous turn undone.]

>undo
New Perspective
[Previous turn undone.]

* * *

>take clamp
Taken.

>combine clamp and spatula
That's not a verb I recognise.

>combine clamp with spatula
That's not a verb I recognise.

* * *

>take tongs
Taken.

>n
You will fall off the edge. Gotta go down first.

>s
You will fall off the edge. Gotta go down first.

>w
You will fall off the edge. Gotta go down first.

>e
You will fall off the edge. Gotta go down first.

>d
Dust Bunny Hideout
You're underneath the table revealing a farm of dust bunnies. The Open Test room is north of you and the table is directly above you.

>n
Test Room
Pitch white walls surround you. There is a tinted window on the north side of the room. There is a table on the south side of the room and a chair on the east side. On the west side of the room, there is a door.

You can see a Big Metal Door here.

>e
Shady Glades
You're underneath the chair blocking out those harshly bright lights providing a cooling shade. The Open Test Room is to the west of you and the chair is directly above you.

* * *

>take clamp
Taken.

>combine clmap with tongs
You can't see any such thing.

>combine clamp with tongs
You fuse together the Clamp and the Pair of Tongs.

You now have a a Clamp Tong Thingy.

>combine clamp tong thing with spatula
I didn't understand that sentence.

>combine clamp tong thingy with spatula
You fuse together the Clamp Tong Thingy and the Spatula.

You now have a an Arm Thingy.

>d
Shady Glades
You're underneath the chair blocking out those harshly bright lights providing a cooling shade. The Open Test Room is to the west of you and the chair is directly above you.

>w
Test Room
Pitch white walls surround you. There is a tinted window on the north side of the room. There is a table on the south side of the room and a chair on the east side. On the west side of the room, there is a door.

You can see a Big Metal Door here.

>open big metal door
You have an arm thingy to unlock the door

>open big metal door with arm thingy
You unlock the Big Metal Door.

>open the big metal door
You open the Big Metal Door.

>w
Hallway
It's not too different from the Test Room, just in hallway shape: There's those bright white walls and cold tile floor. The Test Room is to the East. There's a door to the west that says "Chemical Lab" on it and to the south a door that says "Exit". The Hallway continues to the north, past a trash can in the Northeast corner.

You can see an Exit Door, a Steel Door, a Big Metal Door and an Intern here.

>s
I don't think its a good idea to leave in your current condition.

>n
I don't think you need to go this way to solve you're current problem. There's probably loads of scientists over there who wouldn't think twice about locking you in a box.

>w
You have the arm thingy for a reason.

>open steel door with arm thingy
You unlock the Steel Door.

>open steel door
You open the Steel Door.

>w
Chemical Lab
It's a room taken right out of a science fiction movie. There's a bar to the north with a shelf above it. There's a Cabinent to the west. There's a refrigerator to the south.

You can see a Steel Door here.

>e
Hallway
It's not too different from the Test Room, just in hallway shape: There's those bright white walls and cold tile floor. The Test Room is to the East. There's a door to the west that says "Chemical Lab" on it and to the south a door that says "Exit". The Hallway continues to the north, past a trash can in the Northeast corner.

You can see a Steel Door, a Big Metal Door, an Exit Door and an Intern here.

>ne
Base of the Bin
A giant metal trash can stands before you. I really wouldn't suggest climbing up and going into it. Who know's what kind of toxic waste is thrown in there….ow

>u
Rodent's Paradise
Yuck. I can't believe you are actually in here. Well, I guess it doesn't smell that bad. If you're willing to get your hands dirty, feel free to rummage through this junk.

>x trash
There's a half full milkshake, a plastic bag with a toxic sign on it, orange peels, a crinkled up piece of paper, a wad of tape, and some sticky notes.

>d
Base of the Bin
A giant metal trash can stands before you. I really wouldn't suggest climbing up and going into it. Who know's what kind of toxic waste is thrown in there….ow

>sw
Hallway
It's not too different from the Test Room, just in hallway shape: There's those bright white walls and cold tile floor. The Test Room is to the East. There's a door to the west that says "Chemical Lab" on it and to the south a door that says "Exit". The Hallway continues to the north, past a trash can in the Northeast corner.

You can see a Steel Door, a Big Metal Door, an Exit Door and an Intern here.

* * *

>take tongs
Taken.

>combine tongs with spatula
You fuse together the Pair of Tongs and the Spatula.

You now have a a Spatula Tong Thingy.

>i
You are carrying:
  a Pair of Tongs
  a Spatula

>combine tongs with spatule
You can't see any such thing.

* * *

>combine tongs with spatula
You fuse together the Pair of Tongs and the Spatula.

You now have a a Spatula Tong Thingy.

>d
Dust Bunny Hideout
You're underneath the table revealing a farm of dust bunnies. The Open Test room is north of you and the table is directly above you.

* * *

>e
Shady Glades
You're underneath the chair blocking out those harshly bright lights providing a cooling shade. The Open Test Room is to the west of you and the chair is directly above you.

>x lights
You can't see any such thing.

>x chair
The Chair above you casts a lovely shadow from those harsh lab lights.

>x shadow
You can't see any such thing.

>u
New Perspective
You're on the seat of the chair.

You can see a Clamp here.

>x chair
It's cold hard plastic. Not very accomidating on the scientist's part.

>n
You will fall off the edge. Gotta go down first.

>take clamp
Taken.

>combine clamp with spatula tong thingy
You fuse together the Clamp and the Spatula Tong Thingy.

You now have a an Arm Thingy.

>x arm thingy
A Spatula, A Clamp, and a pair of tongs. Never thought they'd go together - but it seems to be effective!

>d
Shady Glades
You're underneath the chair blocking out those harshly bright lights providing a cooling shade. The Open Test Room is to the west of you and the chair is directly above you.

* * *

>w
Test Room
Pitch white walls surround you. There is a tinted window on the north side of the room. There is a table on the south side of the room and a chair on the east side. On the west side of the room, there is a door.

You can see a Big Metal Door here.

>x door
It's a pretty big door, no matter how big you are.

>open door
You have an arm thingy to unlock the door

>unlock door
(with the Arm Thingy)
You unlock the Big Metal Door.

>w
You can now open the door since the handle has been turned.

>open door
You open the Big Metal Door.

>w
Hallway
It's not too different from the Test Room, just in hallway shape: There's those bright white walls and cold tile floor. The Test Room is to the East. There's a door to the west that says "Chemical Lab" on it and to the south a door that says "Exit". The Hallway continues to the north, past a trash can in the Northeast corner.

You can see an Exit Door, a Steel Door, a Big Metal Door and a Scientist here.

>x lights
Very bright and florecent. It's hard to look directly at them.

>x floor
Abestos tile. Cheap, but it reflects the light very well and seems easy to clean.

>x tile
You can't see any such thing.

* * *

>take tongs
Taken.

>combine spatula with tongs
You fuse together the Spatula and the Pair of Tongs.

You now have a a Spatula Tong Thingy.

>d
Dust Bunny Hideout
You're underneath the table revealing a farm of dust bunnies. The Open Test room is north of you and the table is directly above you.

* * *

>combine clamp with spatula tong thingy
You fuse together the Clamp and the Spatula Tong Thingy.

You now have a an Arm Thingy.

>d
Shady Glades
You're underneath the chair blocking out those harshly bright lights providing a cooling shade. The Open Test Room is to the west of you and the chair is directly above you.

>w
Test Room
Pitch white walls surround you. There is a tinted window on the north side of the room. There is a table on the south side of the room and a chair on the east side. There is a big metal door on the west side of the room.

>w
You can't go that way. There's a closed door.

>open door
It worked!

It seems to be locked.

* * *

>u
Top of the World
Even though you're only four feet off the ground, it seems like you're on top of the world.

You can see a Pair of Tongs here.

>take tong
You can't see any such thing.

>take tongs
Taken.

* * *

>take clamp
Taken.

>combine clamp with tongs
You fuse together the Clamp and the Pair of Tongs.

You now have a a Clamp Tong Thingy.

>combine clamp tong thingy with spatula
You fuse together the Clamp Tong Thingy and the Spatula.

You now have a an Arm Thingy.

* * *

>w
Test Room
Pitch white walls surround you. There is a tinted window on the north side of the room. There is a table on the south side of the room and a chair on the east side. On the west side of the room, there is a door.

You can see a Big Metal Door here.

>open door
You have an arm thingy to unlock the door

* * *

>w
You can now open the door since the handle has been turned.

>w
You can now open the door since the handle has been turned.

* * *

>open door
You open the Big Metal Door.

>w
Hallway
It's not too different from the Test Room, just in hallway shape: There's those bright white walls and cold tile floor. The Test Room is to the East. There's a door to the west that says "Chemical Lab" on it and to the south a door that says "Exit". The Hallway continues to the north, past a trash can in the Northeast corner.

You can see a Steel Door and a Big Metal Door here.

>open door
Which do you mean, the Steel Door or the Big Metal Door?

>w
I only understood you as far as wanting to open west.

>w
(first opening the Steel Door)

Chemical Lab
You can see a Steel Door here.

>w
You can't go that way.

>go through door
Hallway
It's not too different from the Test Room, just in hallway shape: There's those bright white walls and cold tile floor. The Test Room is to the East. There's a door to the west that says "Chemical Lab" on it and to the south a door that says "Exit". The Hallway continues to the north, past a trash can in the Northeast corner.

You can see a Steel Door and a Big Metal Door here.

>enter door
Which do you mean, the Steel Door or the Big Metal Door?

>go west
Chemical Lab
You can see a Steel Door here.

>look
Chemical Lab
You can see a Steel Door here.

>x big metal door
You can't see any such thing.

>actions on
Actions listing on.

>w
[going west]
You can't go that way.
[going west - failed the can't go that way rule]

>e
[going east]

Hallway
It's not too different from the Test Room, just in hallway shape: There's those bright white walls and cold tile floor. The Test Room is to the East. There's a door to the west that says "Chemical Lab" on it and to the south a door that says "Exit". The Hallway continues to the north, past a trash can in the Northeast corner.

You can see a Steel Door and a Big Metal Door here.

[going east - succeeded]

>actions off
Actions listing off.

>w
Chemical Lab
You can see a Steel Door here.

>x lights
You can't see any such thing.

>x floor
You can't see any such thing.

>w
You can't go that way.

* * *

>open door
That's already open.

>w
You can't go that way.

>open chemical door
You can't see any such thing.

>ne
You can't go that way.

>sw
You can't go that way.

>n
You can't go that way.

>ne
You can't go that way.

>u
You can't go that way.

>x trash
You can't see any such thing.

>take all
Hey maybe you should actually TRY and play the game, you little cheater. K, thanks.

>x milkshake
You can't see any such thing.

>take milkshake
You can't see any such thing.

>x bag
You can't see any such thing.

>take bag
You can't see any such thing.

>x peel
You can't see any such thing.

>x peels
You can't see any such thing.

>take peel
You can't see any such thing.

>take peels
You can't see any such thing.

>x paper
You can't see any such thing.

>open paper
You can't see any such thing.

>x paper
You can't see any such thing.

>take paper
You can't see any such thing.

>x tape
You can't see any such thing.

>take tape
You can't see any such thing.

>x hairs
You can't see any such thing.

>take hairs
You can't see any such thing.

>x notes
You can't see any such thing.

>take notes
You can't see any such thing.

>d
You can't go that way.

>sw
You can't go that way.

>l
Chemical Lab
You can see a Steel Door here.

>e
Hallway
It's not too different from the Test Room, just in hallway shape: There's those bright white walls and cold tile floor. The Test Room is to the East. There's a door to the west that says "Chemical Lab" on it and to the south a door that says "Exit". The Hallway continues to the north, past a trash can in the Northeast corner.

You can see a Steel Door and a Big Metal Door here.

* * *

>d
You can't go that way.

>e
Shady Glades
You're underneath the chair blocking out those harshly bright lights providing a cooling shade. The Open Test Room is to the west of you and the chair is directly above you.

* * *

>take clamp
Taken.

>d
Shady Glades
You're underneath the chair blocking out those harshly bright lights providing a cooling shade. The Open Test Room is to the west of you and the chair is directly above you.

>s
You can't go that way.

>w
Test Room
Pitch white walls surround you. There is a tinted window on the north side of the room. There is a table on the south side of the room and a chair on the east side. There is a big metal door on the west side of the room.

>s
Dust Bunny Hideout
You're underneath the table revealing a farm of dust bunnies. The Open Test room is north of you and the table is directly above you.

You can see a Spatula here.

* * *

>take spatula
Taken.

>combine spatula with clamp
You fuse together the Spatula and the Clamp.

You now have a a Clamp Spatula Thingy.

>u
Top of the World
Even though you're only four feet off the ground, it seems like you're on top of the world.

You can see a Pair of Tongs here.

* * *

>take tongs
Taken.

>combine tongs with clamp spatula thingy
You fuse together the Pair of Tongs and the Clamp Spatula Thingy.

You now have a an Arm Thingy.

>i
You are carrying:
  an Arm Thingy

>d
Dust Bunny Hideout
You're underneath the table revealing a farm of dust bunnies. The Open Test room is north of you and the table is directly above you.

* * *

>n
Test Room
Pitch white walls surround you. There is a tinted window on the north side of the room. There is a table on the south side of the room and a chair on the east side. There is a big metal door on the west side of the room.

>open door
It seems to be locked.

>unlock door with armthingy
You can't see any such thing.

>unlock door with arm thingy
You unlock the Big Metal Door.

* * *

>l
Test Room
Pitch white walls surround you. There is a tinted window on the north side of the room. There is a table on the south side of the room and a chair on the east side. There is a big metal door on the west side of the room.

>w
You can't go that way.

* * *

>e
Shady Glades
You're underneath the chair blocking out those harshly bright lights providing a cooling shade. The Open Test Room is to the west of you and the chair is directly above you.

>e
You can't go that way.

>w
Test Room
Pitch white walls surround you. There is a tinted window on the north side of the room. There is a table on the south side of the room and a chair on the east side. There is a big metal door on the west side of the room.

* * *

>e
Shady Glades
You're underneath the chair blocking out those harshly bright lights providing a cooling shade. The Open Test Room is to the west of you and the chair is directly above you.

>u
Chair
It's cold hard plastic. Not very accomidating on the scientist's part.

* * *

>x walls
They are as white as snow and eaily hurt your eyes from the reflection of the lights.

>x lights
Very bright and florecent. It's hard to look directly at them.

>x window
It's tinted and you can't see a thing through it. The scientists were probably observing you from the other side.

>n
You're wasting time. It's a window that you can't see through. Get over it.

>x table
It's probably only a few feet away, but right now it's like a whole nother building to the south of you.

>x chair
It's so close, but yet so far. Let's go get a closer look.

>x door
It's a pretty big door, no matter how big you are.

>s
Dust Bunny Hideout
You're underneath the table revealing a farm of dust bunnies. The Open Test room is north of you and the table is directly above you.

You can see a Spatula here.

* * *

>take bunnies
Those critters aren't going to fit in you back pocket while you're still three inches tall.

>x me
You're dressed casually. You've got a green t-shirt on and black shorts. Oh and you're also only 3 inches tall.

>take spatula
Taken.

>x table
Directly above you stands a steel table. Are you up for a climb?

>u
Top of the World
Even though you're only four feet off the ground, it seems like you're on top of the world.

You can see a Pair of Tongs here.

* * *

>take tongs
Taken.

>x tongs
Looks like it could be used for extracting things…. Or maybe something else.

>x spatula
Not what you would normally find in you're kitchen. This Spatula is definitely more suited for a science lab.

>d
Dust Bunny Hideout
You're underneath the table revealing a farm of dust bunnies. The Open Test room is north of you and the table is directly above you.

>u
Top of the World
Even though you're only four feet off the ground, it seems like you're on top of the world.

>n
You will fall off the edge. Gotta go down first.

>d
Dust Bunny Hideout
You're underneath the table revealing a farm of dust bunnies. The Open Test room is north of you and the table is directly above you.

* * *

>n
Test Room
Pitch white walls surround you. There is a tinted window on the north side of the room. There is a table on the south side of the room and a chair on the east side. On the west side of the room, there is a door.

You can see a Big Metal Door here.

>open door
You can't reach the handle. Remember- You're three inches tall!!

* * *

>everyday i'm shuffling
Hallway
It's not too different from the Test Room, just in hallway shape: There's those bright white walls and cold tile floor. The Test Room is to the East. There's a door to the west that says "Chemical Lab" on it and to the south a door that says "Exit". The Hallway continues to the north, past a Trash Bin in the Northeast corner.

You can see a Steel Door, a Front Door, a Big Metal Door and a Guy here.

>talk scientist
I only understood you as far as wanting to talk.

* * *

>everyday i'm shuffling
Hallway
It's not too different from the Test Room, just in hallway shape: There's those bright white walls and cold tile floor. The Test Room is to the East. There's a door to the west that says "Chemical Lab" on it and to the south a door that says "Exit". The Hallway continues to the north, past a Trash Bin in the Northeast corner.

You can see a Steel Door, a Front Door, a Big Metal Door and a Guy here.

>x trash can
I only understood you as far as wanting to examine the Trash Bin.

>x trash bin
You can't see much from here. Maybe you should get a closer look.

>ne
Base of the Bin
A giant metal trash can stands before you. I really wouldn't suggest climbing up and going into it. Who know's what kind of toxic waste is thrown in there….

>x trash
A huge rubbish bin lurks above you. Dare to climb in?

>u
Rodent's Paradise
Yuck. I can't believe you are actually in here. Well, I guess it doesn't smell that bad. If you're willing to get your hands dirty, feel free to rummage through this junk.

* * *

>x trash
There's a half full milkshake, a plastic bag with a toxic sign on it, orange peels, a crinkled up piece of paper, a wad of tape, and some sticky notes.

>x milkshake
I guess someone doesn't like chocolate milkshakes.

>take milkshake
It's an X-tra large, and your X-tra small.

>x bag
There's an eerie green glow eminating from behind the Toxic symbol.

>x symbol
You can't see any such thing.

>take bag
That eerie green glow is a major warning sign to NOT take it.

>x peels
Just the skin of an orange, with some gnarly mold growing on it.

>take peel
You can't see any such thing.

>take peels
You can only carry so much, and you really want to take the moldy old orange peels over everything else? Well, it's you're choice….

Taken.

>x paper
Seems to be all crinkled up in a ball.

>open paper
You open the Piece of Paper.

>x paper
It seems to have writing on it: 
 ENLARGING CHEMICAL COMBONATION 
 Chemical X 
 Potassium 
 Mercury

>take paper
If you really think this will come in handy
Taken.

>d
Base of the Bin
A giant metal trash can stands before you. I really wouldn't suggest climbing up and going into it. Who know's what kind of toxic waste is thrown in there….

>se
You can't go that way.

>sw
Hallway
It's not too different from the Test Room, just in hallway shape: There's those bright white walls and cold tile floor. The Test Room is to the East. There's a door to the west that says "Chemical Lab" on it and to the south a door that says "Exit". The Hallway continues to the north, past a Trash Bin in the Northeast corner.

You can see a Big Metal Door, a Steel Door, a Front Door and a Guy here.

>n
I don't think you need to go this way to solve you're current problem. There's probably loads of scientists over there who wouldn't think twice about locking you in a box.

>x door
Which do you mean, the Big Metal Door, the Steel Door or the Front Door?

>x steel door
A steel door with a sign that says "Chemical Lab".

It looks like it is already open.

>x big metal door
It's a pretty big door, no matter how big you are.

>x exit door
You can't see any such thing.

>x scientist
You can't see any such thing.

>talk to scientist
You caught the attention of the guy, who turned out to be a scientist, and he recognized you. Well, not cause of your face but probably because of your noticable size. He picks you up, takes you away, and locks you in a dark box. There's no way out now.

    *** You have died ***

In that game you scored 0 out of a possible 0, in 23 turns.

Would you like to RESTART, RESTORE a saved game, QUIT or UNDO the last command?

>undo
Hallway
[Previous turn undone.]

>open steel door
It's already open.

>open steel door with arm thingy
You can't see any such thing.

>unlock steel doo
I didn't understand that sentence.

>unlock steel door
What do you want to unlock the Steel Door with?

>unlock steel door with arm thingy
You can't see any such thing.

>w
Chemical Lab
It's a room taken right out of a science fiction movie. There's a bar to the north with a shelf above it. There's a Cabinet to the west. There's a refrigerator to the south.

You can see a Fridge Door and a Steel Door here.

>x bar
Made of gray stone. Nothing that special

>x shelf
It's too far away to examine it from here.

>x cabinet
Let's go get a closer look.

>x cabinet
Let's go get a closer look.

>x refrigerator
Very modern looking with the steel door and long handles

>x door
Which do you mean, the Fridge Door or the Steel Door?

>x fridge door
Luckily the handles stretch all the way from the top to the bottom so you can open the door at any size.

>x handles
they stretch from the top of the door to the base.

>open fridge door
You open the Fridge Door.

>s
Cool Zone
Brrr. It's cold in here.

You can see a Fridge Door, a Mercury and a Magnesium here.

>x mercury
Not the planet FYI

>x magnesium
Magnesium… the twelfth element of the Periodic Table?

>take all
Hey maybe you should actually TRY and play the game, you little cheater. K, thanks.

>take magnesium
Taken.

>take mercury
Taken.

>n
Chemical Lab
It's a room taken right out of a science fiction movie. There's a bar to the north with a shelf above it. There's a Cabinet to the west. There's a refrigerator to the south.

You can see a Fridge Door and a Steel Door here.

>n
Tiled Wall
Tiles stretch out in front of you up to the Bar. The Bar is above you. Wanna go up?

>x tiles
normal stone.

>x bar
Made of gray stone. Nothing that special

>u
Grayscale
You're on top of the Bar. There's nothing on the Bar, but there is a shelf above you with things you can't quite recognize from here.

>u
Edge
You're on top of the shelf and a variety of chemicals stand before you.

>x chemicals
There are many different viles and containers. The labels say that they are: Sugar,  Potassium, Spice, and Chemical X.

>x sugar
Sugar makes you hyper. Maybe sugar will make you're cell division hyper making you grow faster? Eh, maybe not.

>take sugar
Taken.

>x potassium
You can get a good source of Potassium in bananas.

>take potassium
Taken.

>x spice
Um… Cinnamon?

>take spice
Taken.

>x chemical x
Black Guck in a jar. Hey it probably works for something!

>take x
Taken.

>d
Grayscale
You're on top of the Bar. There's nothing on the Bar, but there is a shelf above you with things you can't quite recognize from here.

>d
Tiled Wall
Tiles stretch out in front of you up to the Bar. The Bar is above you. Wanna go up?

>s
Chemical Lab
It's a room taken right out of a science fiction movie. There's a bar to the north with a shelf above it. There's a Cabinet to the west. There's a refrigerator to the south.

You can see a Steel Door and a Fridge Door here.

>e
Hallway
It's not too different from the Test Room, just in hallway shape: There's those bright white walls and cold tile floor. The Test Room is to the East. There's a door to the west that says "Chemical Lab" on it and to the south a door that says "Exit". The Hallway continues to the north, past a Trash Bin in the Northeast corner.

You can see a Steel Door, a Front Door, a Big Metal Door and a Guy here.

>w
Chemical Lab
It's a room taken right out of a science fiction movie. There's a bar to the north with a shelf above it. There's a Cabinet to the west. There's a refrigerator to the south.

You can see a Steel Door and a Fridge Door here.

>w
Base Camp
The cabinet stretches above you.

>x cabinet
You can't see any such thing.

>u
Whitescale
You're on top of the cabinent.

You can see a Bowl (empty) here.

>take bowl
That's fixed in place.

>put chemcial x in bowl
You can't see any such thing.

>put chemical x
I didn't understand that sentence.

>put chemical x to bowl
I didn't understand that sentence.

>x bowl
A Pyrex bowl - perfect for mixing things (*cough *cough *chemicals) in

>place chemical x in bowl
That's not a verb I recognise.

>put mercury in bowl
You put the Mercury into the Bowl.

>put x in bowl
You put the Chemical X into the Bowl.

>put potassium in bowl
You put the Potassium into the Bowl.

>mix
You mix together Potassium, Chemical X and Mercury.

You now have a Potion J.

I beg your pardon?

>i
You are carrying:
  a Mercury
  a Chemical X
  a Potassium
  a Spice
  a Sugar
  a Magnesium
  a Piece of Paper (open but empty)
  an Orange Peels

>x bowl
A Pyrex bowl - perfect for mixing things (*cough *cough *chemicals) in

In the Bowl is a Potion J.

>take potion
Taken.

>eat potion
Did you fix your problem? No. You made it worse. You shrunk even smaller!!! Being as big as an ant, you thought that this was it since you could no longer pick up the viles with your ity bity hands. Luckil, this potion wasn't so strong and only lasted a minute or so. You are now only somewhat small…. as you were before.

>i
You are carrying:
  a Mercury
  a Chemical X
  a Potassium
  a Spice
  a Sugar
  a Magnesium
  a Piece of Paper (open but empty)
  an Orange Peels

>eat potion
You can't see any such thing.

>eat potion
You can't see any such thing.

>take potion j
You can't see any such thing.

>undo
Whitescale
[Previous turn undone.]

>i
You are carrying:
  a Mercury
  a Chemical X
  a Potassium
  a Spice
  a Sugar
  a Magnesium
  a Piece of Paper (open but empty)
  an Orange Peels

>put sugar in bowl
You put the Sugar into the Bowl.

>put spice in bowl
You put the Spice into the Bowl.

>put chemical x in bowl
You put the Chemical X into the Bowl.

>mix
You mix together Chemical X, Spice and Sugar.

You now have a Potion B.

>take potion b
Taken.

>drink potion
You're tingling. Then POOF! You take out your pocket mirror and a weird confused look arrises on your face. You're a… a….. a Powerpuff Girl!!! You're dressed in the typical character outfit: a small square dress with a black horizontal stripe in the middle. You are the new purple powerpuff girl, judging by your purple irises and purple outfit. I mean, who wants to be a regular sized human when you can be a powerpuff girl!! I bet you can fly!!.

>b
That's not a verb I recognise.

>drink potion b
You can't see any such thing.

>eat potion b
You can't see any such thing.

>i
You are carrying:
  a Sugar
  a Spice
  a Chemical X
  a Mercury
  a Potassium
  a Magnesium
  a Piece of Paper (open but empty)
  an Orange Peels

>fly
Wow! You can really fly!! You just sped across the room in mid air at the speed of light! 
 You notice a window to the west. Too small for any regular sized person to fit through, but a Powerpuff Girl could fly right out it!

>escape wes
I didn't understand that sentence.

>escape west
I didn't understand that sentence.

>w
You can't go that way.

>x me
The forth powerpuff girl: Butterfly - the purple powerpuff girl.

>fly out the window
You fly out the window and into the freedom of the sky. You live the rest of your life peacefully as a Powerpuff Girl.

    *** You have won ***

In that game you scored 0 out of a possible 0, in 82 turns.

Would you like to RESTART, RESTORE a saved game, QUIT or UNDO the last command?

>undo
Whitescale
[Previous turn undone.]

>put mercury into bowl
You put the Mercury into the Bowl.

>put chemcal x into bowl
You can't see any such thing.

>put chemical x into bowl
You put the Chemical X into the Bowl.

>put sugar into bowl
You put the Sugar into the Bowl.

>mix
You mix together Sugar, Chemical X and Mercury.

You now have a Potion F.

>take f
Taken.

>drink f
Oh my god. I guess Marvel was right; there are such thing as mutants…. and you're one of them!!!! But, is this necessarily a bad thing? With your slimy exterior and love for sewer, you could get out of here via any gutter you please. 
 
You see an an entcing drain in the middle of the Chemical Lab.

>x me
Mutant Slug Crocodile Hybrid…. I think…

>x drain
It's too far away. Go get a closer look via the way you got up here

>d
Base Camp
The cabinet stretches above you.

>w
You can't go that way.

>e
Chemical Lab
It's a room taken right out of a science fiction movie. There's a bar to the north with a shelf above it. There's a Cabinet to the west. There's a refrigerator to the south.

You can see a Fridge Door and a Steel Door here.

>x drain
Looks like a quick and easy getaway for any type of slug crocodile mutant.

Wouldn't it be easy just to "escape through the drain"?

>escape through drain
You escape through the drain and live the rest of your life out as a mutant slug crocodile hybrid. You still haven't decided whether or not to be a good monster or a terrible villain. But hey, at least your happy. - Plus, with your terrible crocodile claws and terribly forceful powers, you got your revenge on the scientists by gathering an army of the sewer dewellers to come up from the depths of the drains to rain terror onto the science lab. They will never be turning anyone into monopoly size players ever again.

    *** You have won ***

In that game you scored 0 out of a possible 0, in 94 turns.

Would you like to RESTART, RESTORE a saved game, QUIT or UNDO the last command?

>undo
Chemical Lab
[Previous turn undone.]

>w
Base Camp
The cabinet stretches above you.

>u
Whitescale
You're on top of the cabinent.

You can see a Bowl (empty) here.

>put magnesium in bowl
You put the Magnesium into the Bowl.

>put potassium in bowl
You put the Potassium into the Bowl.

>put chemical x in bowl
You put the Chemical X into the Bowl.

>mix
You mix together Chemical X, Potassium and Magnesium.

You now have a Potion C.

>take j
You can't see any such thing.

>i
You are carrying:
  a Magnesium
  a Potassium
  a Chemical X
  a Mercury
  a Sugar
  a Spice
  a Piece of Paper (open but empty)
  an Orange Peels

>drink j
You can't see any such thing.

>take c
Taken.

>drink c
First your legs spring out before you, growing from only one and a half inches in length to three and a half feet. Your body then expands to its normal proportion, pushing you off the little Counter. Your arms stretch out from your body. And last, but certainly not least, your puny head swells up like they do in those Air Heads commercials. You look at yourself. You're back to normal size!!!

Chemical Lab
It's a room taken right out of a science fiction movie. There's a bar to the north with a shelf above it. There's a Cabinent to the west. There's a refrigerator to the south

You can see a Dull Door here.

>undo
Whitescale
[Previous turn undone.]

>x c
I wonder what this does.

>drink c
First your legs spring out before you, growing from only one and a half inches in length to three and a half feet. Your body then expands to its normal proportion, pushing you off the little Counter. Your arms stretch out from your body. And last, but certainly not least, your puny head swells up like they do in those Air Heads commercials. You look at yourself. You're back to normal size!!!

Chemical Lab
It's a room taken right out of a science fiction movie. There's a bar to the north with a shelf above it. There's a Cabinent to the west. There's a refrigerator to the south

You can see a Dull Door here.

>x me
Normal. Just how you like it.

>x bar
Made of gray stone. Nothing that special

>x refrigerator
Very modern looking and luckily the handles go from the base to the top so you can open it at any height.

Hmm.. there's something on the top of the refrigerator… it's a.. um.. oh it looks like a lab coat!

>take coat
Taken.

>e
(first opening the Dull Door)

Hallway
It's not too different from any room here, just in hallway shape: The Test Room is to the East. There's a door to the west that says "Chemical Lab" on it and to the south a door that says "Exit". The Hallway continues to the north, past a trash can in the Northeast corner.

You can see a Metallic Door, a Dull Door, an Exit Door and a Scientist here.

>x steel door
You can't see any such thing.

>x trash can
A Pretty modern looking rubbish bin. Made of metal, like everything else.

>w
Chemical Lab
It's a room taken right out of a science fiction movie. There's a bar to the north with a shelf above it. There's a Cabinent to the west. There's a refrigerator to the south

You can see a Dull Door here.

>open refrigerator
You've already opened it before. There is no sense in looking at it again.

>open door
That's already open.

>e
Hallway
It's not too different from any room here, just in hallway shape: The Test Room is to the East. There's a door to the west that says "Chemical Lab" on it and to the south a door that says "Exit". The Hallway continues to the north, past a trash can in the Northeast corner.

You can see a Dull Door, a Metallic Door, an Exit Door and a Scientist here.

>x big metal door
You can't see any such thing.

>x door
Which do you mean, the Dull Door, the Metallic Door or the Exit Door?

>big metal door
You can't see any such thing.

>x steel door
You can't see any such thing.

>x dull door
You didn't notice it before but the Steel Door turned out to be very Dull looking.

>x metallic door
It doesn't seem so big now, but more metallic-y.

>x exit door
Not only is it the Front Door, but it's also the Exit Door a.k.a. your escape.

>s
There's a door there.
You hear a ding noise letting you know that the door unlocked, but you still need to open it.

>open door
Which do you mean, the Dull Door, the Metallic Door or the Exit Door?

>exit door
I only understood you as far as wanting to exit.

>open exit door
It seems to be locked. Maybe the scientist knows how to open the door.

>x scientist
He's just leaning against the wall, still playing around with his phone. Wow this is a long break.

I'm not sure if you're aware, but you are no longer unnoticable like when you were small.

>x scientist
He's just leaning against the wall, still playing around with his phone. Wow this is a long break.

I'm not sure if you're aware, but you are no longer unnoticable like when you were small.

>talk to scientist
What have you just done. The scientist looks confused when he sees you. He knows you don't belong. It's like he doesn't know who you are at first, but then his eyes light up. "You!" he shouts as he reaches into his pocket. Before you can get away, he tasers you to the ground. You wake up in a dark room with no way out. The scientists made sure to keep you locked up for the rest of your life as a science experiment. 

    *** You have died ***

In that game you scored 0 out of a possible 0, in 121 turns.

Would you like to RESTART, RESTORE a saved game, QUIT or UNDO the last command?

>undo
Hallway
[Previous turn undone.]

>put on lab coat
You put on the lab coat.

>x scientist
He's just leaning against the wall, still playing around with his phone. Wow this is a long break.

With your bright white lab coar, you look just like him! You're incognito.

>x me
Normal. Just how you like it.

>talk to scientist
The Scientist looks up from his phone and scans you with his eye. You are worried that he will notice you, but all your worries wash away when he looks at you and smiles. He says "Can I help you?" - For help talking say "Help".

>help
Talking to the Scientist  
 How do I ______ 
 How do I get _____ 
 How are you

>how are you
The scientist says "I'm well. Thanks for asking."

>how are you?
I didn't understand that sentence.

>how do I open the door
The scientists says "Oh, you need an id to unlock it."

>how do i get an id
The sceintist says, "You know I'd lend you mine, but I've misplaced it. If you can find it, you can use it.

>e
(first opening the Metallic Door)

xTestxRoom
There is a tinted window on the north side of the room. There is a table on the south side of the room and a chair on the east side.

You can see a Metallic Door here.

>look under the table
You see nothing here.

>look under chair
You see nothing here.

>w
Hallway
It's not too different from any room here, just in hallway shape: The Test Room is to the East. There's a door to the west that says "Chemical Lab" on it and to the south a door that says "Exit". The Hallway continues to the north, past a trash can in the Northeast corner.

You can see a Metallic Door, a Dull Door, an Exit Door and a Scientist here.

>ne
You can't go that way.

>n
There is no need to go that way.

>x trash can
A Pretty modern looking rubbish bin. Made of metal, like everything else.

>open trash can
Yuck.

>x trash can
A Pretty modern looking rubbish bin. Made of metal, like everything else.

In the Trash Can is an id.

>take id
Taken.

>talk to scientist
He says "Can I help you?" - For help talking say "Help".

>is this your id
Yes. You can use that to unlock the door.

>unlock door
Which do you mean, the Metallic Door, the Dull Door or the Exit Door?

>unlock exit door with id
You unlock the Exit Door.

>s
There's a door there.
You hear a ding noise letting you know that the door unlocked, but you still need to open it.

>open door
Which do you mean, the Metallic Door, the Dull Door or the Exit Door?

>open exit door
You open the Exit Door.

>s
You exit the science lab and run to your car. You get in and drive away as far as you can, never returning to the sick lab ever again.

    *** You have won ***

In that game you scored 0 out of a possible 0, in 144 turns.

Would you like to RESTART, RESTORE a saved game, QUIT or UNDO the last command?