You've needed extra cash and this science lab was willing to pay good money for you to be a "test bunny". You took this chemical mixture but it did nothing at first so the scientists left you alone in the test room until later on. After and hour you end up being shrunk to three inches tall. You now realize how serious these scientists are and you must figure out how to get yourself back to normal proportions and escape the lab
Tonic
An Interactive Fiction by Brianna Hartner
Release 1 / Serial number 130303 / Inform 7 build 6G60 (I6/v6.32 lib 6/12N) SD

Test Room
Pitch white walls surround you. There is a tinted window on the north side of the room. There is a table on the south side of the room and a chair on the east side. There is a big metal door on the west side of the room.

>who are you?
That's not a verb I recognise.

* * *

>unlock big metal door with arm thingy
You can't see any such thing.

* * *

>l
Test Room
Pitch white walls surround you. There is a tinted window on the north side of the room. There is a table on the south side of the room and a chair on the east side. There is a big metal door on the west side of the room.

* * *

>e
Shady Glades
You're underneath the chair blocking out those harshly bright lights providing a cooling shade. The Open Test Room is to the west of you and the chair is directly above you.

* * *

>u
Chair
It's cold hard plastic. Not very accomidating on the scientist's part.

>d
Shady Glades
You're underneath the chair blocking out those harshly bright lights providing a cooling shade. The Open Test Room is to the west of you and the chair is directly above you.

* * *

>n
You can't go that way.

>s
Table Underside
Here the table acutally blocks those super bright lights and provides a nice cooling shade. The Open Test room is north of you and the table is directly above you.

>u
Table Underside
Here the table acutally blocks those super bright lights and provides a nice cooling shade. The Open Test room is north of you and the table is directly above you.

* * *

>take thingy
Taken.

* * *

>w
Hallway
It's not too different from the Test Room, just in hallway shape: There's those bright white walls and cold tile floor. The Test Room is to the East. There's a door to the west that says "Chemical Lab" on it and to the south a door that says "Exit". The Hallway continues to the north, past a rubbish bin in the Northeast corner.

>w
You can't go that way.

>x door
It's a pretty big door, no matter how big you are.

>open door
It seems to be locked.

>unlock door
What do you want to unlock the Big Metal Door with?

>unlock door with key
You can't see any such thing.

* * *

>s
Dust Bunny Hideout
You're underneath the table revealing a farm of dust bunnies. The Open Test room is north of you and the table is directly above you.

>u
Table
It's made of a flat metal surface and four skinny stainless steel legs. It's about four feet tall and looks like it belongs in a science lab - oh wait it's in a science lab….⁥湡⁤潦牵猠楫湮

* * *

>s
Dust Bunny Hideout
You're underneath the table revealing a farm of dust bunnies. The Open Test room is north of you and the table is directly above you.

>x bunnies
They are big and gray and scary.